1111111111111111111111111111111111111111111111111111111111111111111111111111111111111111111111111111
1000000000000000000000000000000000000000000000000000000000000000000000000000000000000000000000000001
1000000000000000000000000000000000000000000000000000000000000000000000000000000000000000000000000001
1000000000000000000000000000000000000000000011111000000000000000000000000001101000000000000000000001
1100000000000000000000000000000000000000000011111000000000000000000000000000000110001111000000000001
1111100000000000000000000000000000000000000000011000000000000000000111110000000000000000000000000001
1000001110000000000000000000000000000000000000000000000000000000000000000000000000000111100000000001
1000000000011010000000000000000000000000000000011000000000000000000000011100000000111100000000000001
1000000111111111000000000000110110000000000011111000001111100000000000000000000000000000000000000001
1000000000000000000000000011110110111000000000000000000000111100000100011000000000000000000000000001
1000000000000000000011111110000000011000000010000000000000000000000000000000000000000000000000000001
1000000000000000000000000000000111111000000010000000000011111111000000000000000000000000000000000001
1000000000000000000000000000000000000000000110000000000000000000100000000000000000000000000000000001
1000000000000000000000000011000000000000000001100000000000000011111000000000111100000000000000000001
1000000000110000000000000011100000101000000000011000000000000000000000000000001100000000000000000001
1000000001111011100000000000000110010010000000000000000000000000000011110000111111100000000000000001
1000000000000000000000000000000111000000000000000000000100011000000000000000111000000000000000000001
1000001110000000000000000000011100000000000000000111011111000000000000001100111000000000000000000001
1111011000000000000000000000000000000000000000011100000011000000000000000000111000000000000000000001
1111111111111111111111111111111111111111111111111111111111111111111111111111111111111111111111111111
