11111111111111111111111111111111111111111111111111
10000000000000000000000000000000000000000000000001
10000000000000000000000000000000000000000000000001
10000000000000000000000000000000000000000000111111
11000000000000000000000000000000000000000000111111
11111000000000000000000000000000000000000000000111
10000011100000000000000000000000000000000000000001
10000000000110100000000000000000000000000000000111
10000001111111110000000000001101100000000000111111
10000000000000000000000000111101101110000000000001
10000000000000000000111111100000000110000000000001
10000000000000000000000000000001111110000000000001
10000000000000000000000000000000000000000000000001
10000000000000000000000000110000000000000000000001
10000000001100000000000000111000001010000000000001
10000000011110111000000000000001100100100000000001
10000000000000000000000000000001110000000000000001
10000011100000000000000000000000000000000000000001
11110110000000000000000000000000000000000000000001
11111111111111111111111111111111111111111111111111
